S is more usual than M?<extra_id_0> S is more usual.	Yes,	Yes,
K is less civilian than Z?<extra_id_0> Z is more military.	No,	No,
M is less inefficient than S?<extra_id_0> M is less competent.	No,	Yes,
P is more harmless than U?<extra_id_0> P is less dangerous.	Yes,	Yes,
S is not nearer than K?<extra_id_0> K is not further.	Yes,	No,
P is more ordinary than Z?<extra_id_0> P is more extraordinary.	No,	No,
P is not nearer than G?<extra_id_0> G is not closer.	No,	No,
S is more conscious than W?<extra_id_0> S is more conscious.	Yes,	Yes,
U is less ordinary than M?<extra_id_0> M is less ordinary.	No,	Yes,
Z is not weaker than U?<extra_id_0> Z is stronger.	Yes,	No,
M is less inefficient than W?<extra_id_0> W is less incompetent.	No,	No,
K is more distant than S?<extra_id_0> K is not closer.	Yes,	No,
M is not happier than S?<extra_id_0> M is happier.	No,	No,
G is less inaccessible than S?<extra_id_0> G is less accessible.	No,	No,
S is less immoral than W?<extra_id_0> S is less immoral.	Yes,	Yes,
U is not further than S?<extra_id_0> S is less distant.	No,	No,
Z is less related than P?<extra_id_0> Z is less unrelated.	No,	No,
K is more unreasonable than Z?<extra_id_0> K is more unreasonable.	Yes,	Yes,
W is more irresponsible than S?<extra_id_0> W is less irresponsible.	No,	No,
W is more unethical than P?<extra_id_0> P is less unethical.	Yes,	No,
S is less successful than G?<extra_id_0> G is less successful.	No,	Yes,
U is less unusual than K?<extra_id_0> K is less unusual.	No,	No,
W is more abundant than S?<extra_id_0> W is less abundant.	No,	No,
G is less incorrect than P?<extra_id_0> G is more incorrect.	No,	No,
Z is nearer than M?<extra_id_0> Z is closer.	Yes,	Yes,
W is more correct than G?<extra_id_0> G is less correct.	Yes,	No,
Z is less competent than M?<extra_id_0> Z is less incompetent.	No,	No,
U is less unconditional than S?<extra_id_0> U is more conditional.	Yes,	Yes,
W is less detached than P?<extra_id_0> W is more concerned.	Yes,	Yes,
P is less incompetent than S?<extra_id_0> P is less inefficient.	Yes,	No,
M is more constitutional than G?<extra_id_0> M is less constitutional.	No,	No,
M is more common than W?<extra_id_0> W is more common.	No,	No,
P is longer than Z?<extra_id_0> Z is taller.	No,	No,
G is not further than Z?<extra_id_0> Z is further.	Yes,	Yes,
G is less uncommon than K?<extra_id_0> K is less ordinary.	Yes,	No,
U is less conscious than K?<extra_id_0> U is more conscious.	No,	No,
G is more extraordinary than U?<extra_id_0> G is less uncommon.	No,	No,
P is less related than S?<extra_id_0> P is more unrelated.	Yes,	Yes,
U is more ordinary than P?<extra_id_0> U is more ordinary.	Yes,	Yes,
S is not closer than U?<extra_id_0> S is less distant.	No,	No,
U is more distant than W?<extra_id_0> W is nearer.	Yes,	No,
U is further than M?<extra_id_0> M is nearer.	Yes,	No,
P is taller than U?<extra_id_0> U is not taller.	Yes,	No,
G is not safer than Z?<extra_id_0> Z is more dangerous.	No,	No,
U is more abundant than W?<extra_id_0> W is less abundant.	Yes,	No,
S is weaker than M?<extra_id_0> M is not weaker.	Yes,	No,
M is happier than P?<extra_id_0> M is more melancholy.	No,	No,
P is safer than W?<extra_id_0> P is safer.	Yes,	Yes,
G is less harmless than U?<extra_id_0> G is less dangerous.	No,	No,
W is more harmless than G?<extra_id_0> G is less harmless.	Yes,	No,
P is less unconscious than M?<extra_id_0> M is less unconscious.	No,	No,
S is more successful than P?<extra_id_0> S is more unsuccessful.	No,	No,
Z is more monstrous than U?<extra_id_0> Z is more beautiful.	No,	No,
S is happier than M?<extra_id_0> M is more unhappy.	Yes,	No,
U is less melancholy than W?<extra_id_0> W is more unhappy.	Yes,	No,
M is more frivolous than W?<extra_id_0> M is less serious.	Yes,	Yes,
W is more harmless than Z?<extra_id_0> W is less harmless.	No,	No,
K is further than W?<extra_id_0> K is nearer.	No,	No,
P is more common than W?<extra_id_0> P is more common.	Yes,	Yes,
K is stronger than G?<extra_id_0> K is weaker.	No,	No,
M is more casual than K?<extra_id_0> K is less concerned.	No,	Yes,
W is less irresponsible than S?<extra_id_0> W is less responsible.	No,	Yes,
W is weaker than U?<extra_id_0> W is weaker.	Yes,	Yes,
K is further than G?<extra_id_0> K is less distant.	No,	No,
P is more competent than S?<extra_id_0> S is more incompetent.	Yes,	No,
W is stronger than U?<extra_id_0> W is stronger.	Yes,	Yes,
P is more mortal than Z?<extra_id_0> Z is more mortal.	No,	No,
M is less military than Z?<extra_id_0> M is more civilian.	Yes,	Yes,
U is more unconstitutional than G?<extra_id_0> G is less unconstitutional.	Yes,	No,
Z is less internal than K?<extra_id_0> Z is more external.	Yes,	No,
U is more unusual than P?<extra_id_0> U is more unusual.	Yes,	Yes,
W is more unhappy than P?<extra_id_0> P is less unhappy.	Yes,	No,
M is not closer than W?<extra_id_0> M is not closer.	Yes,	No,
S is more unreasonable than K?<extra_id_0> S is more reasonable.	No,	Hence,
S is more unrelated than Z?<extra_id_0> Z is more related.	Yes,	No,
M is closer than P?<extra_id_0> M is less distant.	Yes,	Yes,
U is less conscious than M?<extra_id_0> U is less conscious.	Yes,	Yes,
W is less extraordinary than U?<extra_id_0> W is more ordinary.	Yes,	Yes,
G is less monstrous than M?<extra_id_0> M is less beautiful.	Yes,	No,
P is not further than Z?<extra_id_0> P is further.	No,	Then
Z is more melancholy than W?<extra_id_0> W is more unhappy.	No,	No,
M is more usual than G?<extra_id_0> G is more unusual.	Yes,	No,
W is not closer than U?<extra_id_0> U is not nearer.	No,	No,
M is less common than G?<extra_id_0> G is more common.	Yes,	No,
U is more unsuccessful than K?<extra_id_0> U is less successful.	Yes,	Yes,
U is less practical than P?<extra_id_0> U is more impractical.	Yes,	Yes,
U is more immortal than S?<extra_id_0> U is less immortal.	No,	No,
K is not nearer than S?<extra_id_0> K is not closer.	Yes,	No,
K is more insensitive than G?<extra_id_0> G is less sensitive.	No,	No,
Z is less usual than W?<extra_id_0> Z is less usual.	Yes,	Yes,
P is less distant than K?<extra_id_0> P is less distant.	Yes,	Yes,
W is more casual than K?<extra_id_0> W is less concerned.	Yes,	Yes,
G is not longer than M?<extra_id_0> M is not longer.	No,	No, G is not longer
G is not further than W?<extra_id_0> G is closer.	Yes,	No,
W is not tighter than G?<extra_id_0> W is less insufficient.	Yes,	No,
G is less insensitive than M?<extra_id_0> M is less sensitive.	Yes,	No,
W is more unusual than Z?<extra_id_0> W is more usual.	No,	Yes,
W is less accessible than M?<extra_id_0> W is less accessible.	Yes,	Yes,
M is less concerned than G?<extra_id_0> G is less detached.	Yes,	No,
W is tighter than Z?<extra_id_0> W is not tighter.	No,	No,
K is less unusual than Z?<extra_id_0> K is more unusual.	No,	No,
U is less concerned than W?<extra_id_0> U is more casual.	Yes,	Yes,
Z is less partial than U?<extra_id_0> Z is less impartial.	No,	No,
G is less harmless than M?<extra_id_0> M is more harmless.	Yes,	No,
P is more immoral than S?<extra_id_0> P is less immoral.	No,	No,
U is more predictable than K?<extra_id_0> U is less unpredictable.	Yes,	Yes,
U is more inefficient than M?<extra_id_0> U is less competent.	Yes,	Yes,
Z is tighter than U?<extra_id_0> U is tighter.	No,	No,
U is less reasonable than W?<extra_id_0> W is more reasonable.	Yes,	No,
P is more unethical than Z?<extra_id_0> Z is more ethical.	Yes,	No,
G is less responsible than P?<extra_id_0> G is more irresponsible.	Yes,	Yes,
W is less detached than Z?<extra_id_0> W is more casual.	No,	Yes,
W is more unhappy than G?<extra_id_0> W is not happier.	Yes,	No,
G is not stronger than M?<extra_id_0> G is stronger.	No,	No,
W is more practical than Z?<extra_id_0> Z is less impractical.	No,	No,
M is more melancholy than K?<extra_id_0> M is not happier.	Yes,	No,
G is less external than U?<extra_id_0> U is more internal.	No,	No,
W is not longer than U?<extra_id_0> U is taller.	Yes,	No, W is longer than
P is more dangerous than M?<extra_id_0> P is less harmless.	Yes,	No,
S is less grotesque than G?<extra_id_0> G is more beautiful.	No,	No,
W is less unreasonable than S?<extra_id_0> W is less reasonable.	No,	Yes,
Z is more insufficient than P?<extra_id_0> Z is less abundant.	Yes,	Yes,
S is more inefficient than M?<extra_id_0> S is more inefficient.	Yes,	Yes,
M is less dangerous than Z?<extra_id_0> M is less harmless.	No,	Yes,
U is more unsuccessful than Z?<extra_id_0> Z is more successful.	Yes,	No,
S is more moral than W?<extra_id_0> S is less immoral.	Yes,	No,
S is more common than W?<extra_id_0> W is less common.	Yes,	No,
K is more abundant than U?<extra_id_0> K is more insufficient.	No,	No,
K is less inefficient than U?<extra_id_0> K is more incompetent.	No,	Yes,
S is more uncommon than U?<extra_id_0> U is less common.	No,	No,
W is more impractical than U?<extra_id_0> W is less practical.	Yes,	Yes,
G is less harmless than K?<extra_id_0> G is safer.	No,	No,
W is less insufficient than Z?<extra_id_0> W is more insufficient.	No,	No,
M is more sensitive than G?<extra_id_0> G is less sensitive.	Yes,	No,
U is less insensitive than G?<extra_id_0> G is less insensitive.	No,	No,
S is less monstrous than W?<extra_id_0> S is less grotesque.	Yes,	Yes,
S is not happier than K?<extra_id_0> S is not happier.	Yes,	No,
G is less external than M?<extra_id_0> M is less internal.	Yes,	No,
S is less ordinary than U?<extra_id_0> U is less extraordinary.	Yes,	No,
P is less monstrous than M?<extra_id_0> P is less beautiful.	No,	No,
M is more occupied than P?<extra_id_0> M is less vacant.	Yes,	No,
U is not further than M?<extra_id_0> M is more distant.	Yes,	No,
G is not further than M?<extra_id_0> M is not closer.	Yes,	No,
U is more unethical than M?<extra_id_0> U is more ethical.	No,	No,
M is less serious than U?<extra_id_0> U is more serious.	Yes,	No,
G is less sensitive than S?<extra_id_0> G is more insensitive.	Yes,	Yes,
Z is less abundant than U?<extra_id_0> Z is less abundant.	Yes,	Yes,
W is more detached than Z?<extra_id_0> W is more detached.	Yes,	Yes,
S is less predictable than U?<extra_id_0> U is more unpredictable.	No,	Yes,
M is more extraordinary than W?<extra_id_0> W is less common.	No,	No,
W is more concerned than U?<extra_id_0> W is more concerned.	Yes,	Yes,
W is more ordinary than G?<extra_id_0> G is more uncommon.	Yes,	No,
U is not taller than S?<extra_id_0> U is shorter.	Yes,	No,
K is less accessible than G?<extra_id_0> K is more accessible.	No,	No,
G is less unrelated than S?<extra_id_0> S is less unrelated.	No,	No,
K is taller than M?<extra_id_0> K is not longer.	No,	No,
K is less unconstitutional than Z?<extra_id_0> K is more unconstitutional.	No,	No,
W is more incompetent than S?<extra_id_0> W is more incompetent.	Yes,	Yes,
U is less practical than S?<extra_id_0> S is more impractical.	No,	No,
W is less incorrect than M?<extra_id_0> M is more correct.	No,	No,
P is less abundant than W?<extra_id_0> P is less insufficient.	No,	No,
M is more common than U?<extra_id_0> M is more extraordinary.	No,	No,
Z is less theoretical than U?<extra_id_0> Z is less empirical.	No,	No,
U is more unethical than Z?<extra_id_0> Z is less ethical.	No,	No,
M is less unconditional than Z?<extra_id_0> Z is less conditional.	Yes,	No,
U is more concerned than W?<extra_id_0> W is less casual.	No,	No,
M is not happier than P?<extra_id_0> P is happier.	Yes,	No,
M is less unethical than G?<extra_id_0> M is less unethical.	Yes,	Yes,
G is less partial than Z?<extra_id_0> Z is more impartial.	No,	No,
M is less uncommon than P?<extra_id_0> M is less extraordinary.	Yes,	Yes,
Z is more monstrous than S?<extra_id_0> S is less grotesque.	Yes,	No,
P is less casual than S?<extra_id_0> S is more concerned.	No,	No,
G is not happier than Z?<extra_id_0> Z is more unhappy.	No,	No,
U is more mortal than P?<extra_id_0> U is less immortal.	Yes,	No,
W is tighter than G?<extra_id_0> G is less insufficient.	Yes,	No,
M is more vacant than P?<extra_id_0> P is less occupied.	No,	No,
S is less empirical than G?<extra_id_0> S is more theoretical.	Yes,	Yes,
K is happier than P?<extra_id_0> P is less melancholy.	No,	No,
Z is less dangerous than U?<extra_id_0> U is less harmless.	Yes,	No,
M is more common than G?<extra_id_0> M is less uncommon.	Yes,	Yes,
K is less grotesque than M?<extra_id_0> M is more monstrous.	Yes,	No,
Z is not tighter than G?<extra_id_0> Z is not tighter.	Yes,	No,
U is less reasonable than Z?<extra_id_0> U is less unreasonable.	No,	No,
Z is more detached than W?<extra_id_0> Z is less detached.	No,	No,
K is less unconscious than W?<extra_id_0> K is more unconscious.	No,	No,
W is less serious than P?<extra_id_0> W is less frivolous.	No,	No,
S is less successful than G?<extra_id_0> G is more successful.	Yes,	Yes,
G is less ethical than U?<extra_id_0> G is less unethical.	No,	No,
S is more competent than U?<extra_id_0> S is more incompetent.	No,	No,
G is longer than Z?<extra_id_0> Z is longer.	No,	Yes,
Z is more unethical than M?<extra_id_0> Z is more unethical.	Yes,	Yes,
M is less beautiful than Z?<extra_id_0> Z is less monstrous.	Yes,	No,
U is less monstrous than M?<extra_id_0> M is less grotesque.	No,	No,
K is less theoretical than M?<extra_id_0> M is more theoretical.	Yes,	No,
P is more competent than K?<extra_id_0> P is less competent.	No,	No,
U is more immoral than W?<extra_id_0> W is more immoral.	No,	Yes,
P is less empirical than M?<extra_id_0> P is less theoretical.	No,	No,
S is less abundant than Z?<extra_id_0> Z is tighter.	No,	Yes,
W is more reasonable than U?<extra_id_0> W is less reasonable.	No,	No,
U is more mortal than G?<extra_id_0> G is more immortal.	Yes,	No,
G is less unconditional than U?<extra_id_0> G is less conditional.	No,	Yes,
P is more extraordinary than G?<extra_id_0> P is less ordinary.	Yes,	No,
K is more empirical than Z?<extra_id_0> Z is less theoretical.	No,	No,
W is less competent than K?<extra_id_0> W is more competent.	No,	No,
K is more monstrous than M?<extra_id_0> M is more monstrous.	No,	No,
W is more impractical than G?<extra_id_0> G is more impractical.	No,	No,
U is less military than G?<extra_id_0> U is less civilian.	No,	No,
P is more harmless than G?<extra_id_0> P is safer.	Yes,	Yes,
M is not taller than P?<extra_id_0> M is not longer.	Yes,	No, because
M is tighter than K?<extra_id_0> K is less abundant.	No,	Yes,
G is taller than U?<extra_id_0> U is longer.	No,	No,
M is not shorter than U?<extra_id_0> U is shorter.	Yes,	No,
M is more correct than G?<extra_id_0> G is more correct.	No,	No,
U is more beautiful than S?<extra_id_0> U is less grotesque.	Yes,	Yes,
Z is less monstrous than W?<extra_id_0> Z is less monstrous.	Yes,	Yes,
P is nearer than K?<extra_id_0> P is more distant.	No,	No,
G is more insensitive than K?<extra_id_0> K is more insensitive.	No,	No,
G is not shorter than Z?<extra_id_0> Z is taller.	No,	No,
Z is less inefficient than S?<extra_id_0> Z is less incompetent.	Yes,	Yes,
Z is more successful than G?<extra_id_0> Z is less successful.	No,	No,
P is more unhappy than U?<extra_id_0> U is not happier.	No,	No,
K is not tighter than P?<extra_id_0> P is tighter.	Yes,	No,
U is less unusual than S?<extra_id_0> S is more usual.	No,	No,
Z is not longer than S?<extra_id_0> S is shorter.	No,	No,
K is further than U?<extra_id_0> K is closer.	No,	No,
S is less impartial than M?<extra_id_0> M is less impartial.	No,	No,
Z is less unconstitutional than P?<extra_id_0> Z is more constitutional.	Yes,	Yes,
K is more internal than W?<extra_id_0> W is less internal.	Yes,	No,
M is more casual than P?<extra_id_0> M is more casual.	Yes,	Yes,
G is more irresponsible than Z?<extra_id_0> G is more responsible.	No,	No,
S is less unsuccessful than Z?<extra_id_0> S is more successful.	Yes,	Yes,
K is more unsuccessful than G?<extra_id_0> K is less unsuccessful.	No,	No,
Z is more external than W?<extra_id_0> W is more external.	No,	No,
G is less accessible than W?<extra_id_0> G is more inaccessible.	Yes,	Yes,
U is less conditional than M?<extra_id_0> U is more unconditional.	Yes,	Yes,
G is taller than K?<extra_id_0> G is shorter.	No,	No,
K is safer than S?<extra_id_0> S is safer.	No,	No,
P is not closer than Z?<extra_id_0> Z is not further.	Yes,	No,
P is less immoral than M?<extra_id_0> M is more immoral.	Yes,	No,
Z is less monstrous than S?<extra_id_0> S is more grotesque.	Yes,	No,
S is less casual than W?<extra_id_0> S is less concerned.	No,	Yes,
K is less uncommon than Z?<extra_id_0> K is more uncommon.	No,	No,
M is more competent than S?<extra_id_0> S is more inefficient.	Yes,	No,
U is less predictable than W?<extra_id_0> U is more predictable.	No,	No,
P is more vacant than M?<extra_id_0> P is more vacant.	Yes,	Yes,
P is more casual than W?<extra_id_0> W is more detached.	No,	No,
S is more reasonable than W?<extra_id_0> S is less unreasonable.	Yes,	Yes,
Z is less melancholy than S?<extra_id_0> S is happier.	No,	No,
S is more abundant than Z?<extra_id_0> Z is tighter.	Yes,	Yes, but
M is more common than W?<extra_id_0> W is less extraordinary.	No,	No,
W is more empirical than P?<extra_id_0> P is more theoretical.	Yes,	No,
P is not shorter than W?<extra_id_0> P is not longer.	No,	No,
U is less frivolous than K?<extra_id_0> U is more serious.	Yes,	Yes,
K is more practical than P?<extra_id_0> K is less impractical.	Yes,	No,
P is less harmless than U?<extra_id_0> U is less dangerous.	Yes,	No,
G is less partial than W?<extra_id_0> G is more impartial.	Yes,	Yes,
G is more impartial than M?<extra_id_0> M is more partial.	Yes,	No,
S is more ordinary than Z?<extra_id_0> S is less uncommon.	Yes,	Yes,
U is more melancholy than M?<extra_id_0> M is happier.	Yes,	No,
Z is less competent than P?<extra_id_0> P is more competent.	Yes,	No,
P is less partial than M?<extra_id_0> M is more partial.	Yes,	No,
U is not tighter than P?<extra_id_0> U is less abundant.	No,	No, because
S is less distant than P?<extra_id_0> P is not further.	No,	No,
M is less military than G?<extra_id_0> G is less military.	No,	No,
U is more unconditional than G?<extra_id_0> U is less unconditional.	No,	No,
P is less melancholy than M?<extra_id_0> P is not happier.	No,	No,
G is more inaccessible than P?<extra_id_0> P is less inaccessible.	Yes,	No,
P is more theoretical than W?<extra_id_0> P is less theoretical.	No,	No,
M is less harmless than Z?<extra_id_0> M is less harmless.	Yes,	Yes,
K is less external than Z?<extra_id_0> K is less internal.	No,	No,
G is more casual than K?<extra_id_0> K is more concerned.	Yes,	No,
W is less beautiful than P?<extra_id_0> W is more grotesque.	Yes,	No,
Z is more ordinary than G?<extra_id_0> G is less extraordinary.	No,	No,
Z is less inefficient than S?<extra_id_0> Z is more inefficient.	No,	Yes,
G is less detached than K?<extra_id_0> G is less detached.	Yes,	Yes,
K is more unconditional than P?<extra_id_0> K is more unconditional.	Yes,	Yes,
M is more sensitive than G?<extra_id_0> G is more insensitive.	Yes,	No,
G is less distant than M?<extra_id_0> G is nearer.	Yes,	Yes,
Z is not weaker than U?<extra_id_0> U is stronger.	No,	No,
P is less concerned than U?<extra_id_0> P is more concerned.	No,	No,
M is less internal than P?<extra_id_0> P is less internal.	No,	No,
S is safer than K?<extra_id_0> S is less harmless.	No,	No,
M is nearer than K?<extra_id_0> K is less distant.	No,	No,
G is less correct than U?<extra_id_0> U is more correct.	Yes,	No,
U is more distant than G?<extra_id_0> G is not closer.	No,	No,
M is less unconscious than K?<extra_id_0> M is more conscious.	Yes,	Yes,
S is more frivolous than U?<extra_id_0> S is more serious.	No,	No,
U is more beautiful than K?<extra_id_0> U is less beautiful.	No,	No,
S is more irresponsible than Z?<extra_id_0> Z is less irresponsible.	Yes,	No,
M is more immortal than K?<extra_id_0> K is less immortal.	Yes,	No,
U is less accessible than W?<extra_id_0> W is less accessible.	No,	No,
M is taller than S?<extra_id_0> M is taller.	Yes,	Yes -
M is less ethical than K?<extra_id_0> K is less ethical.	No,	No,
P is less civilian than S?<extra_id_0> S is less military.	Yes,	No,
M is more unconstitutional than S?<extra_id_0> M is more constitutional.	No,	No,
W is less incorrect than M?<extra_id_0> M is more incorrect.	Yes,	No,
G is more vacant than P?<extra_id_0> G is less vacant.	No,	No,
P is more external than K?<extra_id_0> P is less internal.	Yes,	No,
P is more incorrect than U?<extra_id_0> U is less incorrect.	Yes,	No,
Z is more sensitive than W?<extra_id_0> W is more sensitive.	No,	No,
S is less conditional than U?<extra_id_0> S is more conditional.	No,	No,
G is more constitutional than K?<extra_id_0> K is more constitutional.	No,	No,
G is less insufficient than K?<extra_id_0> G is less insufficient.	Yes,	Yes,
U is less extraordinary than M?<extra_id_0> M is less extraordinary.	No,	No,
P is more vacant than S?<extra_id_0> P is less occupied.	Yes,	Yes,
W is less impartial than K?<extra_id_0> K is less partial.	Yes,	No,
M is less responsible than P?<extra_id_0> P is less irresponsible.	Yes,	No,
W is less occupied than P?<extra_id_0> P is more occupied.	Yes,	No,
G is less unpredictable than P?<extra_id_0> G is more predictable.	Yes,	Yes,
U is more frivolous than K?<extra_id_0> U is more frivolous.	Yes,	Yes,
M is less conditional than P?<extra_id_0> P is less conditional.	No,	No,
G is more practical than K?<extra_id_0> G is more practical.	Yes,	Yes,
M is less occupied than G?<extra_id_0> M is less vacant.	No,	Yes,
U is less unhappy than M?<extra_id_0> U is more unhappy.	No,	No,
G is less competent than U?<extra_id_0> G is less inefficient.	No,	No,
Z is less constitutional than W?<extra_id_0> W is less unconstitutional.	Yes,	No,
Z is less common than G?<extra_id_0> G is more ordinary.	Yes,	Yes,
U is less competent than M?<extra_id_0> U is more incompetent.	Yes,	Yes,
U is less uncommon than K?<extra_id_0> U is less common.	No,	Yes,
P is less extraordinary than S?<extra_id_0> S is more common.	No,	No,
P is more predictable than K?<extra_id_0> K is less predictable.	Yes,	No,
G is less distant than S?<extra_id_0> G is not closer.	No,	No,
G is less mortal than U?<extra_id_0> U is less mortal.	No,	No,
Z is less inaccessible than S?<extra_id_0> S is less inaccessible.	No,	No,
P is less frivolous than W?<extra_id_0> W is more serious.	No,	No,
G is not nearer than Z?<extra_id_0> Z is less distant.	Yes,	No,
Z is not further than P?<extra_id_0> Z is not nearer.	No,	No,
W is less monstrous than Z?<extra_id_0> Z is less monstrous.	No,	No,
S is less civilian than M?<extra_id_0> S is more military.	Yes,	No,
Z is more related than K?<extra_id_0> K is more related.	No,	No,
M is less inaccessible than K?<extra_id_0> K is more inaccessible.	Yes,	No,
M is more predictable than P?<extra_id_0> M is more unpredictable.	No,	No,
K is less immortal than Z?<extra_id_0> K is less immortal.	Yes,	Yes,
W is more grotesque than S?<extra_id_0> S is less beautiful.	No,	No,
W is more unreasonable than U?<extra_id_0> U is less unreasonable.	Yes,	No,
K is more common than P?<extra_id_0> K is less extraordinary.	Yes,	No,
W is less unhappy than S?<extra_id_0> W is less melancholy.	Yes,	Yes,
G is less unrelated than P?<extra_id_0> G is less unrelated.	Yes,	Yes,
P is not longer than G?<extra_id_0> G is not shorter.	Yes,	No,
S is not longer than M?<extra_id_0> S is not taller.	Yes,	No,
M is more extraordinary than K?<extra_id_0> M is more uncommon.	Yes,	Yes,
K is less common than P?<extra_id_0> P is more uncommon.	No,	No,
S is shorter than U?<extra_id_0> S is shorter.	Yes,	Yes,
W is weaker than M?<extra_id_0> W is not weaker.	No,	No,
G is more frivolous than P?<extra_id_0> P is more frivolous.	No,	No,
S is less predictable than Z?<extra_id_0> Z is more predictable.	Yes,	Yes,
W is less theoretical than S?<extra_id_0> S is less empirical.	Yes,	No,
K is more impartial than P?<extra_id_0> P is less partial.	No,	No,
P is less uncommon than Z?<extra_id_0> Z is more extraordinary.	Yes,	No,
K is less conscious than G?<extra_id_0> G is more unconscious.	No,	No,
M is less immoral than Z?<extra_id_0> Z is less moral.	Yes,	No,
G is less correct than S?<extra_id_0> G is less incorrect.	No,	No,
G is more mortal than Z?<extra_id_0> Z is less immortal.	No,	No,
W is more distant than P?<extra_id_0> W is closer.	No,	No,
K is more occupied than S?<extra_id_0> K is less occupied.	No,	No,
P is nearer than M?<extra_id_0> M is not further.	No,	No,
W is less beautiful than M?<extra_id_0> M is less beautiful.	No,	Yes,
Z is less extraordinary than G?<extra_id_0> Z is more uncommon.	No,	No,
U is safer than M?<extra_id_0> M is more harmless.	No,	No,
S is less civilian than Z?<extra_id_0> S is less military.	No,	No,
U is less casual than W?<extra_id_0> W is less casual.	No,	No,
Z is less moral than S?<extra_id_0> Z is less immoral.	No,	No,
U is more responsible than W?<extra_id_0> W is more irresponsible.	Yes,	No,
U is more responsible than P?<extra_id_0> U is less responsible.	No,	No,
U is less constitutional than M?<extra_id_0> U is less constitutional.	Yes,	Yes,
Z is less predictable than K?<extra_id_0> Z is less unpredictable.	No,	Yes,
W is more conscious than G?<extra_id_0> G is more unconscious.	Yes,	No,
U is less uncommon than G?<extra_id_0> G is less uncommon.	No,	No,
U is more harmless than G?<extra_id_0> U is not safer.	No,	No,
K is more civilian than P?<extra_id_0> P is less civilian.	Yes,	No,
P is less moral than Z?<extra_id_0> Z is more immoral.	No,	No,
S is more related than W?<extra_id_0> S is more related.	Yes,	Yes,
U is more unrelated than K?<extra_id_0> K is less related.	No,	Yes,
W is more impractical than P?<extra_id_0> P is less practical.	No,	No,
